11111111111111111111111
10000000000000000000001
10111110101010101111101
10001000101010100010001
10101010101010101010101
10100010011011001000101
10110111NNNCNNN11101101
10000000N11N11N00000001
10111111N1CCC1N11111101
10000000N11111N00000001
10110111NNNNNNN11101101
10100010011011001000101
10101010101010101010101
10001000101010100010001
10111110101010101111101
10000000000P00000000001
11111111111111111111111