11111111111111111111111
10000000001010000000001
10101110101010101110101
10000000001010000000001
10111111101010111111101
10000000001010000000001
10111111100C00111111101
10000000001010000000001
1111111101CCC1011111111
10000000011111000000001
10110111000000011101101
10100010011011001000101
10101010101010101010101
10001000101010100010001
10111110101010101111101
10000000001P10000000001
11111111111111111111111