1111111111111111111111111111
1000000000000110000000000001
1011110111110110111110111101
1011110111110110111110111101
1000000000000000000000000001
1011110110111111110110111101
1011110110111111110110111101
1000000110000110000110000001
111111011111N11N111110111111
NNNNN1011NNNNNNNNNN1101NNNNN
NNNNN1011N11111111N1101NNNNN
111111011N1NNNNNN1N110111111
NNNNNNNNNN1NNNNNN1NNNNNNNNNN
111111011N1NNNNNN1N110111111
NNNNN1011N11111111N1101NNNNN
NNNNN1011NNNNNNNNNN1101NNNNN
111111011N11111111N110111111
100000011N11111111N110000001
1011110000000110000000111101
1000110111110110111110110001
1110110111110110111110110111
1110110000000000000000110111
1110110110111111110110110111
1110110110111111110110110111
1000000110000110000110000001
1011111111110110111111111101
1011111111110110111111111101
1000000000000000000000000001
1111111111111111111111111111